15
10
333333333333333
303000000500303
300000000000003
303303303303303
303000000000303
300020000000003
333333333333333
300000000000003
303000000000303
333333333333333
