45
30
333333333333333333333333333333333333333333333
333333333333333333333333333333333333333333333
350000000000000000000000000000000000000000333
303333333333333333333333333333333333333330333
303000000000000000000000000333333333333330333
303033333333333333333333330333333333333330333
303000000033000003300000330000033000003300003
303030333033033303303330330333033033303303303
303030333000033300003330000333000033300003000
303030333033033303303330330333033033303303303
303030000033000003300000330000033000003300003
303033333333333333333333330333333333333330333
303033333333333333333333330333333333333330333
303033333333333333333333330333333333333330333
300000000000000000000000000000000000000000333
300000000000000000002000000000000000000000333
303033333333333333333333330333333333333330333
303033333333333333333333330333333333333330333
303033333333333333333333330333333333333330333
303030000033000003300000330000033000003300003
303030333033033303303330330333033033303303303
303030333000033300003330000333000033300003000
303030333033033303303330330333033033303303303
303000000033000003300000330000033000003300003
303033333333333333333333330333333333333330333
303000000000000000000000000333333333333330333
303333333333333333333333333333333333333330333
300000000000000000000000000000000000000000333
333333333333333333333333333333333333333333333
333333333333333333333333333333333333333333333
