45
30
333333333333333333333333333333333333333333333
350000000000000000000000000000000000000000003
333330333333303333333303333333303333333033333
300000000000000000000000000000000000000000003
303330333033303330033303330033303330333033303
303300033033000330033000330033000330330003303
303333333033333330033333330033333330333333303
300000000000000000000000000000000000000000003
300000000000000000000000000000000200000000003
333330333333303333333303333333303333333033333
300000000000000000000000000000000000000000003
303330333033303330033303330033303330333033303
303300033033000330033000330033000330330003303
303333333033333330033333330033333330333333303
300000000000000000000000000000000000000000003
300000000000000000000000000000000000000000003
333330333333303333333303333333303333333033333
300000000000000000000000000000000000000000003
303330333033303330033303330033303330333033303
303300033033000330033000330033000330330003303
303333333033333330033333330033333330333333303
300000000000000000000000000000000000000000003
300000000000000000000000000000000000000000003
333330333333303333333303333333303333333033333
300000000000000000000000000000000000000000003
303330333033303330033303330033303330333033303
303300033033000330033000330033000330330003303
303333333033333330033333330033333330333333303
300000000000000000000000000000000000000000003
333333333333333333333333333333333333333333333