45
30
333333333333333333333333333333333333333333333
333333333333333333333333333333333333333333333
500000003000000003000000003000000003000000003
030333303030333303030333303030333303030333303
030000303030000303030000303030000303030000303
030330303030330303030330303030330303030330303
030330303030330303030330303030330303030330303
030330303030330303030330303030330303030330303
030000303030000303030000303030000303030000303
030333303030333303030333303030333303030333303
000000003000000003000000003000000003000000003
000000003000000003000000003002000003000000003
333333303333333303333333303333333303333333303
333333303333333303333333303333333303333333303
333333303333333303333333303333333303333333303
000000000000000000000000000000000000000000000
333333303333333303333333303333333303333333303
333333303333333303333333303333333303333333303
000000003000000003000000003000000003000000003
000000003000000003000000003000000003000000003
030333303030333303030333303030333303030333303
030000303030000303030000303030000303030000303
030330303030330303030330303030330303030330303
030330303030330303030330303030330303030330303
030330303030330303030330303030330303030330303
030000303030000303030000303030000303030000303
030333303030333303030333303030333303030333303
000000003000000003000000003000000003000000003
333333333333333333333333333333333333333333333
333333333333333333333333333333333333333333333