45
30
333333333333333333333333333333333333333333333
350000000000003300000000000003300000000000003
303333333333303303333333333303303333333333303
303000000000303303000000000303303000000000303
303333030333303303333030333303303333030333303
300000000000003300000000000003300000000000003
303333333333300003333333333300003333333333303
303000000000300003000000000300003000000000303
303033333330303303033333330303303033333330303
303033333330303303033333330303303033333330303
303000000000303303000000000303303000000000303
303330303333303303330303333303303330303333303
300000000000003300000000002003300000000000003
333033333330333333033333330333333033333330333
333033333330333333033333330333333033333330333
333033333330333333033333330333333033333330333
333033333330333333033333330333333033333330333
300000000000003300000000000003300000000000003
303333333333303303333333333303303333333333303
303000000000303303000000000303303000000000303
303333030333303303333030333303303333030333303
300000000000003300000000000003300000000000003
303333333333300003333333333300003333333333303
303000000000300003000000000300003000000000303
303033333330303303033333330303303033333330303
303033333330303303033333330303303033333330303
303000000000303303000000000303303000000000303
303330303333303303330303333303303330303333303
300000000000003300000000000003300000000000003
333333333333333333333333333333333333333333333
