45
30
333333333333333333333333333333333333333333333
350000003300000003300000003300000003300000003
303303303303303303303303303303303303303303303
303000303303000303303000303303000303303000303
303000303303000303303000303303000303303000303
303333303303333303303333303303333303303333303
300000003300000003300000003300000003300000003
333333303333333303333333303333333303333333303
303333303303333303303333303303333303303333303
303333303303333303303333303303333303303333303
303333303303333303303333303303333303303333303
303333303303333303303333303303333303303333303
303333303303333303303333303303333303303333303
303303303303303303303303303303303303303303303
300000000000000000000000000000020000000000000
303303333303303333303303333303303333303303333
303303333303303333303303333303303333303303333
303303333303303333303303333303303333303303333
303303333303303333303303333303303333303303333
303303333303303333303303333303303333303303333
303303333303303333303303333303303333303303333
333303333333303333333303333333303333333303333
300000003300000003300000003300000003300000003
303303303303303303303303303303303303303303303
303000303303000303303000303303000303303000303
303000303303000303303000303303000303303000303
303333303303333303303333303303333303303333303
300000003300000003300000003300000003300000003
333333333333333333333333333333333333333333333
333333333333333333333333333333333333333333333
