45
30
333333333333333333333333333333333333333333333
335000000003300000000033000000000330000000003
300000000003000000000030000000000300000000003
300033333003000333330030003333300300033333003
300030000000000300000000003000000000030000003
300030003000000300030000003000300000030003003
300030000000000300000000003000000000030000003
300033333003000333330030003333300300033333003
300000000003000000000030000000000300000000003
330000000003300000000033000000000330000000003
333333333303333333333033333333330333333333303
330000000003300000000033000000000330000000003
300000000003000000000030000000000300000000003
300033333003000333330030003333300300033333003
300030000000000300000000003000000200030000003
300030003000000300030000003000300000030003003
300030000000000300000000003000000000030000003
300033333003000333330030003333300300033333003
300000000003000000000030000000000300000000003
330000000003300000000033000000000330000000003
333333333303333333333033333333330333333333303
330000000003300000000033000000000330000000003
300000000003000000000030000000000300000000003
300033333003000333330030003333300300033333003
300030000000000300000000003000000000030000003
300030003000000300030000003000300000030003003
300030000000000300000000003000000000030000003
300033333003000333330030003333300300033333003
300000000003000000000030000000000300000000003
330000000003300000000033000000000330000000003
