45
30
333333333333333333333333333333333333333333333
350000033300000033300000033300000033300000033
303333003303333003303333003303333003303333003
303003000303003000303003000303003000303003000
300003000000003000000003000000003000000003000
303003000303003000303003000303003000303003000
303333003303333003303333003303333003303333003
300000033300000033300000033300000033300000033
303333333303333333303333333303333333303333333
303333333303333333303333333303333333303333333
303333333303333333303333333303333333303333333
303333333303333333303333333303333333303333333
303333333303333333303333333303333333303333333
303333333303333333303333333303333333303333333
303333333303333333303333333303333333303333333
303333333303333333303333333323333333303333333
303333333303333333303333333303333333303333333
303333333303333333303333333303333333303333333
303333333303333333303333333303333333303333333
303333333303333333303333333303333333303333333
303333333303333333303333333303333333303333333
303333333303333333303333333303333333303333333
300000033300000033300000033300000033300000033
303333003303333003303333003303333003303333003
303003000303003000303003000303003000303003000
300003000000003000000003000000003000000003000
303003000303003000303003000303003000303003000
303333003303333003303333003303333003303333003
300000033300000033300000033300000033300000033
333333333333333333333333333333333333333333333
