45
30
333333333333333333333333333333333333333333333
500000000000000000000000000000000000000000003
033333303033333303033333303033333303033333303
030000303030000303030000303030000303030000303
030330303030330303030330303030330303030330303
000000000000000000000000000000000000000000003
030330300030330300030330300030330300030330303
030000303030000303030000303030000303030000303
033333303033333303033333303033333303033333303
000000003000000003000000003000000003000000003
000000003000000003000000003000000003000000003
033333303033333303033333303033333303033333303
030000303030000303030000303030000303030000303
030330303030330303030330303030330303030330303
000000000000000000000002000000000000000000003
030330303030330303030330303030330303030330303
030000303030000303030000303030000303030000303
033333303033333303033333303033333303033333303
000000003000000003000000003000000003000000003
000000003000000003000000003000000003000000003
033333303033333303033333303033333303033333303
030000303030000303030000303030000303030000303
030330303030330303030330303030330303030330303
000000000000000000000000000000000000000000003
030330300030330300030330300030330300030330303
030000303030000303030000303030000303030000303
033333303033333303033333303033333303033333303
000000003000000003000000003000000003000000003
333333333333333333333333333333333333333333333
333333333333333333333333333333333333333333333
