45
30
333333333333333333333333333333333333333333333
333333500003333333330000033333333300000333333
333330030300333333300303003333333003030033333
333300330330033333003303300333330033033003333
333003300033003330033000330033300330003300333
330033000003300300330000033003003300000330033
300330033300330003300333003300033003330033003
303300033300033033000333000330330003330003303
303330033300333033300333003330333003330033303
300333033303330003330333033300033303330333003
330033000003300300330000033003003300000330033
333003300033003330033000330033300330003300333
333300330330033333003303300333330033033003333
333330030300333333300303003333333003030033333
333333000003333333330000033333333300000333333
333333000003333333330000033333333300000333333
333330030300333333300303003333333003030033333
333300330330033333003303300333330033033003333
333003300033003330033000330033300330003300333
330033000003300300330000033003003300000330033
300330033300330003300333003300033003330033003
303300033300033033000333000330330003330203303
303330033300333033300333003330333003330033303
300333033303330003330333033300033303330333003
330033000003300300330000033003003300000330033
333003300033003330033000330033300330003300333
333300330330033333003303300333330033033003333
333330030300333333300303003333333003030033333
333333000003333333330000033333333300000333333
333333333333333333333333333333333333333333333
