45
30
333333333333333333333333333333333333333333333
350000000000000000000000000000000000000000003
300033300033300033300033300033300033300033303
300003300003300003300003300003300003300003303
303000003000003000003000003000003000003000003
303330303330303330303330303330303330303330303
300000000000000000000000000000000000000000003
303333303333303333303333303333303333303333303
303333303333303333303333303333303333303333303
303333303333303333303333303333303333303333303
303333303333303333303333303333303333303333303
303333303333303333303333303333303333303333303
300000000000000000000000000000000000000000003
300033300033300033300033300033300033300033303
300003300003300003300003300003300003300003303
303000003000003000003000003000003000003000003
303330303330303330303330303330303330303330303
300000000000000000000002000000000000000000003
303333303333303333303333303333303333303333303
303333303333303333303333303333303333303333303
303333303333303333303333303333303333303333303
303333303333303333303333303333303333303333303
303333303333303333303333303333303333303333303
300000000000000000000000000000000000000000003
303330303330303330303330303330303330303330303
303300003300003300003300003300003300003300003
300003300003300003300003300003300003300003303
300033300033300033300033300033300033300033303
300000000000000000000000000000000000000000003
333333333333333333333333333333333333333333333
